+-+-+-+-+-+-+-+-+-+-+-+-+-+-+
    |     |                 |
+ +-+-+-+ + +-+-+ +-+-+ +-+-+
| |     |   | |     |   |   |
+ + +-+-+-+ + + +-+-+-+-+ +-+
|             | |   |     | |
+ +-+-+-+-+-+-+-+-+ + + + + +
|     |   | | | | |   | | | |
+-+ +-+ +-+ + + + +-+ +-+ + +
| |       |   | |       | | |
+ + +-+ + + +-+ + + + +-+ + +
|     | | |   |   | |   |   |
+ + +-+-+-+-+ + +-+ +-+ +-+-+
| | |   |   |     |   | |   |
+-+ + +-+-+ +-+-+ +-+-+-+ + +
|     | | |       | |     | |
+-+ +-+ + +-+-+-+ + +-+-+-+ +
|           |     | |       |
+ +-+-+ + + + +-+ + +-+-+ +-+
| |     | | | |         | | |
+-+-+ +-+ +-+-+ + + +-+ + + +
|   | |         | |   | |   |
+ +-+-+-+ +-+ +-+-+ + + +-+ +
|     |   | |   |   | |     |
+-+ +-+-+-+ + + + +-+-+-+-+ +
| | |       | | | |     | | |
+ + +-+-+ +-+-+ +-+-+-+ + + +
| |                   |     |
+ + + +-+-+-+ + +-+-+-+-+ +-+
|   |   |     |       |     
+-+-+-+-+-+-+-+-+-+-+-+-+-+-+
