+-+-+-+-+-+-+-+-+-+-+-+-+-+-+-+
  |       | |   |       | |   |
+ +-+ +-+-+ + +-+ +-+ + + + + +
|     |             | |   | | |
+ + +-+-+ +-+-+-+ + +-+ + + + +
| |     |     | | | | | |   | |
+ + +-+ + +-+-+ + +-+ +-+ + +-+
| |   |   |   |         | |   |
+-+ + +-+ +-+ +-+ +-+-+-+ +-+-+
| | |   | |       | | |       |
+ +-+-+-+-+-+ + +-+ + +-+-+ + +
|     | |     |   |       | | |
+ +-+ + +-+-+ + +-+-+ +-+-+-+ +
|   |     |   | | |     |     |
+-+-+-+-+ + + + + +-+-+ +-+ +-+
|   |   |   | |   | |         |
+-+ + +-+-+ +-+-+-+ +-+ +-+-+ +
| |   |       |   | | | |   | |
+ + +-+-+-+ +-+ +-+ + + + +-+ +
|     |     |               | |
+-+-+ + + +-+-+ +-+-+-+-+ +-+-+
| | |   | |   | | |           |
+ + +-+ +-+ +-+-+ + +-+ + +-+-+
| |     |   |     | |   |     |
+ + + +-+ +-+ +-+-+ +-+ + +-+ +
| | |       |     | |   | | | |
+ + + +-+-+ + + + +-+ + +-+ + +
|   |     | | | | | | | | |   |
+ +-+ + +-+-+ +-+-+ + + + + +-+
| |   |   | | |   |   | | |   |
+-+ +-+-+-+ + + +-+ +-+-+ + +-+
|       |       |     |   |   |
+-+ +-+-+-+ +-+ +-+ +-+-+ + + +
| |   | | | |       |   |   | |
+ +-+-+ + +-+-+-+-+ + +-+-+-+ +
| | | |     | |   | |   | | | |
+ + + +-+ +-+ +-+ + + +-+ + + +
|   |   |     | |     | | |   |
+-+ +-+ +-+ +-+ + +-+-+ + +-+ +
|       | | | |       | |     |
+ +-+-+ + + + +-+-+-+ + +-+-+ +
|     |       |         |     |
+ +-+-+ +-+-+-+ +-+ +-+ +-+ +-+
| | |       | | | | |   |     |
+-+ + + +-+-+ + + +-+-+-+-+ + +
|     |       | | |       | | |
+-+-+ +-+-+ + +-+ + +-+ + + +-+
|   |     | |         | |     |
+-+ + +-+-+-+-+-+ +-+-+-+-+ + +
| |     |   |         |   | | |
+ +-+ + + +-+-+-+ +-+ + + + + +
| |   |     | | | |     | | | |
+ + +-+ +-+ + + +-+-+-+-+ +-+ +
| |   |   |     |         | | |
+ +-+ +-+ +-+ + +-+-+-+ + + +-+
|     |     | | |       |     |
+ +-+-+ +-+-+ + + +-+ + + + +-+
| |         | | | |   | | |   |
+ + +-+ + +-+ +-+-+ +-+ +-+-+ +
| | |   |   |     | |     |   
+-+-+-+-+-+-+-+-+-+-+-+-+-+-+-+
